11111111111
1PEC0000001
1000C000C01
11111111111